#################################
#..............+................#
#...+......................+....#
#...............................#
#............@.......+..........#
#....+....................+.....#
#...............................#
#..........+...B................#
#......................+........#
#....+.....................+....#
#...............................#
#################################