#################################
#...............................#
#...+......................+....#
#............+..................#
#............@....+.............#
#....+....................+.....#
#...............................#
#..........+...B................#
#......................+........#
#....+.....................+....#
#...............................#
#################################