#################################
#...............................#
#...............................#
#...............................#
#............@..................#
#.........+++++++++.............#
#...............................#
#...............................#
#...............................#
#...............................#
#...............................#
#################################